                 ########  #########        #######         
                 #······#  #·······#        #·····#         
                 #······#  #·······#        #·····#         
                 #·###·##  #·#######        #·····#         
     ########    #·# #·#   #·#              #·#####         
     #······######·# #·#   #·# #########    #·#             
     #·············# #·#   #·# #·······#    #·#             
     #······######## #·#   #·# #·······#    #·#             
     #·####·###      #·##  #·# #·#######    #·#             
     #·#  #···#      #··#  #·# #·#          #·#      #######
     #·#  #···#      #··####·###·############·########·····#
     #·#  #···#      #·····································#
     #·#  #···#      #··············#########·########·····#
     #·#  #·###      #··####·###·##·#       #·#      ###█###
     #·#  #·#        ####  #·# #·##·#       #·#             
     #·#  #·#              #·# #·##·####### #·#             
     #·#  #·######         #·# #·##·······# #·#             
     #·#  #·##···#         #·# #·##·······# #·#             
     #·#  #·##···###########·###·############·#             
     #·#  #·##·························@······#             
  ####·#  #·##···###########·###·##############             
  #····#  #·##·###         #·# #·#                          
  #····####·##·#           #·# #·#                          
  #·········##·#############·###·#                          
  #····#·························#                          
  ######··········################                          
       ############                                         
                                                            
                                                            
                                                            
50
